Apim=Apim
ASyncExecution=Asynkron Batchkørsel
AsyncJobDescription=FO Integration Asynkront Job
AsyncProcessing=Asynkron Behandling
AsyncPull=Asynkron Hentning
AsyncPush=Asynkron Push
AwaitingAsyncProcessing=Afventer Asynkron Behandling
AwaitingAsyncPull=Afventer Asynkron Hentning
ClaimCheck=ClaimCheck
ClaimCheckRest=Claimcheck skal bruge RestTransport
ClaimCheckServicebus=Claimcheck skal bruge ServicebusTransport
ClaimCheckSetup=ClaimCheck Opsætning
ClaimCheckType=Type
ClassNotConverted=Klassenavn '%1' kunne ikke konverteres til en klasseId
Completed=Fuldført
CorrelationId=KorrelationId
CorrelationIdHelp=KorrelationId fra et andet system
Direction=Retning
DirectionHelp=Er integrationen Indgående eller Udgående
DirectionIn=Indgående
DirectionOut=Udgående
EmptyData=Tom outputdata fundet i forespørgsel '%1', med runid '%2'
Ended=Afsluttet
Error=Fejl
ErrorHelp=Fejl fra integrationen
Exception=Undtagelse
ExceptionFormat=Undtagelse '%1', Fejl '%2', Stacktrace '%3'
ExceptionHelp=Undtagelse fra integrationen
ExecutionCount=Udførelses Tælling
ExecutionCountHelp=Antal gange forespørgslen blev forsøgt
Failed=Mislykket
Identifier=Identifikator
IdentifierHelp=Identifikator for forespørgslen
IdentifierRun=Kørselsidentifikator
IdentifierRunHelp=Identifikator for behandling af forespørgslen
Inbound=Indgående
InboundSetup=Indgående Opsætning
InboundSync=Indgående Synk
InboundType=Indgående Type
IncorrectState=Forespørgsel '%1' i ukorrekt tilstand '%2'
InitIntegrations=Initialiser Integrationer
Input=Input
InputHelp=Input til integration
IntegrationNotFound=Integration '%1' ikke fundet
IntegrationParametersDevDoc=Standardparameterformular brugt til modulet
IntegrationRequest=Integrationsforespørgsel
IntegrationRequestData=Integrationsforespørgselsdata
IntegrationRequestDataHelp=Integrationsforespørgselsdata, gemt med identifikatoren og en kørselsidentifikator
IntegrationRequestDevDoc=Tabel med modtagne forespørgsler
IntegrationRequestException=Undtagelser under integration
IntegrationRequestHelp=Forespørgsel logget med frameworket
Integrations=Integrationer
IntegrationSetup=Integrationsopsætning
IntegrationSetupDevDoc=Tabel med opsætning for integrationer
IntegrationSetupValue=Værdier for integration
IntegrationSetupValueDevDoc=Værdier brugt til integration, oprettet fra kode
IntegrationType=Integrationstype
Keyword=Nøgleord
Keyword1=Nøgleord1
Keyword2=Nøgleord2
Keyword3=Nøgleord3
KeywordHelp=Nøgleord udtrukket fra en forespørgsel
Keywords=Nøgleord
MissingData=Manglende data for integration '%1' med identifikator '%2', og kørselsidentifikator '%3'
MissingException=Forespørgsel er i tilstand '%1', og ingen undtagelse fundet
MissingOutboundIntegration=Manglende Udgående Integration
MissingSetup=Manglende opsætning for integrationsklasse '%1' med identifikator '%2'
New=Ny
NewRequest=Ny Forespørgsel
NoClassAssigned=Ingen klasse tildelt til integration '%1'
NoSupportForAsyncPull=Integration '%1' understøtter ikke asynkron hentning
NoToken=Ingen Token i Svar '%1'
Obsolete=Forældet
Outbound=Udgående
OutboundAsync=Udgående Asynkron
OutBoundIntegration=Ny Tekst
OutboundSetup=Udgående Opsætning
OutboundSync=Udgående Synk
Output=Output
OutputHelp=Output fra integration
Parameteres=Parameter
ParseError=Kan ikke fortolke svar '%1'
Periodic=Periodisk
Processing=Behandler
Queue=Kø
QueueTopic=Kø/Emne
Recieved=Modtaget
RelatedRequest=Relateret forespørgsel
Removefailed=Slet Fejlede
RemoveProcessed=Slet Fuldførte
RequestData=Forespørgselsdata
RequestInfo=Forespørgselsinfo
Requests=Forespørgsler
ReRun=Genkør
RerunFailed=Genkør mislykkedes
Schedulet=Planlagt
Secret=Hemmelig
SecretHelp=Er værdien hemmelig
ServiceBus=Servicebus
Setup=Opsætning
SetupCreateValues=Opret opsætningsværdier
SetupValues=Opsætningsværdier
StackTrace=Stakspor
StackTraceHelp=Staksporet fra fejlen
State=Tilstand
StateHelp=Tilstand for integrationen
SupportAsync=Understøtter Asynkron
SupportAsyncHelp=Understøtter integrationen asynkron
Sync=Synkron
Time=Tid
Timestamp=Tidsstempel
TimestampHelp=Tidspunkt for ...
Topic=Topic
TopicNotFound=Kø/Topic ikke fundet '%1'
Transport=Transport
UnknownIdentifier=Ukendt integrationsidentifikator '%1'
Unsupported=Ikke understøttet
Value=Værdi
ValueHelp=Værdi brugt i udgående integration
ValueId=Id
ValueIdHelp=Id brugt i udgående integration
Workspace=Arbejdsområde