AsyncJobDescription=FO Integration Async Job
AsyncPull=AsyncPull
AsyncPush=AsyncPush
AwaitingAsyncProcessing=AwaitingAsyncProcessing
AwaitingAsyncPull=AwaitingAsyncPull
ClassNotConverted=ClassName '%1' could not be converted to a classId
Completed=Completed
Direction=Direction
DirectionHelp=Is integration Inbound or outbound
DirectionIn=Inbound
DirectionOut=Outbound
EmptyData=Empty output data found in request '%1', with runid '%2'
Error=Error
ErrorHelp=Error from the integration
Exception=Exception
ExceptionFormat=Exception '%1', Error '%2', Stacktrace '%3'
ExceptionHelp=Exception from the integration
ExecutionCount=Execution Count
ExecutionCountHelp=Number of times the request was retried
Failed=Failed
Identifier=Identifier
IdentifierHelp=Identifier for the requst
IdentifierRun=Run identifier
IdentifierRunHelp=Identifier for the processing of the request
InboundType=Inbound type
IncorrectState=Request '%1' in incorrect state '%2'
Input=Input
InputHelp=Input to integration
IntegrationNotFound=Integration '%1' not found
IntegrationParametersDevDoc=Standard parameters form used for the module
IntegrationRequest=Integrationrequest
IntegrationRequestData=Integration request data
IntegrationRequestDataHelp=Integration request data, stored with the identifier and a run identifier
IntegrationRequestDevDoc=Table containing recieved requests
IntegrationRequestException=Exceptions during integration
Integrations=Integrations
IntegrationSetup=Integration Setup
IntegrationSetupDevDoc=Table with setup for integrations
IntegrationSetupValue=Values for integration
IntegrationSetupValueDevDoc=Values used for integration, created from code
Keyword=Keyword
Keyword1=Keyword1
Keyword2=Keyword2
Keyword3=Keyword3
KeywordHelp=Keywords extracted from a request
Keywords=Keywords
MissingData=Missing data for integration '%1' with identifier '%2', and runIdentifier '%3'
MissingException=Request is in State '%1', and no exception found
MissingSetup=Missing setup for integrationClass '%1' with identifier '%2'
New=New
NewLabel0=Label files created on 04/18/2024 06:01:09 for label file Id Integrations_INT and language en-US
 ;Label file comment - see above label
NoClassAssigned=No class asssigned to integration '%1'
NoSupportForAsyncPull=Integration '%1' does not support Async pull
NoToken=No Token in Response '%1'
OutBoundIntegration=New Text
Output=Output
OutputHelp=Output from integration
Parameteres=Parameter
ParseError=Unable to parse response '%1'
Periodic=Periodic
Processing=Processing
RelatedRequest=Related request
Requests=Requests
Secret=Secret
SecretHelp=Is property a secret
Setup=Setup
StackTrace=Stack trace
StackTraceHelp=The stack trace from the error
State=State
StateHelp=State of the integration
SupportAsync=Supports Async
SupportAsyncHelp=Does the integration supports Async
Sync=Sync
Timestamp=TimeStamp
TimestampHelp=Time of the ...
UnknownIdentifier=Unknown integration identifier '%1'
Value=Value
ValueHelp=Value used in outbound integration
ValueId=Id
ValueIdHelp=Id used in outbound integration
Workspace=Workspace
